####################
#                  #
# ################ #
# #              # #
# #              # #
# #              # #
# #              # #
# #              # #
# #              # #
o #              # x
# #              # #
# #              # #
# #              # #
# #              # #
# #              # #
# #              # #
# #              # #
# ######## ####### #
#                  #
####################
