###########
o #      ##
#   #### ##
###   ##  x
### #### ##
#      # ##
#   # ## ##
### #  # ##
### # #  ##
#   #   ###
###########