###########
#         #
# ####### #
# #     # #
# #     # #
o #     # x
# #     # #
# #     # #
# ### ### #
#         #
###########